W4;W3;W3;W3;W4;
W3;R2;R1;R2;W3;
W3;R1;R1;R1;W3;
W3;R2;R1;R2;W3;
W4;W3;W3;W3;W4;